1111111111111
1E001000001E1
10C010CC10101
1000100010101
1P00100010101
100CCC0010001
1000000010001
1111111111111
