1111111111111
1000100000101
10C010CC10101
10P0100010101
1000100010101
100CCC0010001
1000000010001
1111111111111
