1111
10P1
1001
1001
1001
1001
1001
10C1
1001
1001
1001
1001
10E11
1001
1001
1111
