1111111111111
10001000101E1
10C010CC10101
10P0100010101
1000100010101
100CCC0010001
1000000010001
1111111111111
