11111111111
1P0000000B1
10101011101
101C100C101
10111011101
1000101C001
10001011101
100000000E1
11111111111
