11111111111
1P001000001
1E1000000B1
101C0010001
1C100000001
1C000000001
11111111111
